18 17 31 80 35
##########
## ## #  #
#@  #  S #
#S   S  ##
#  ##   ##
# #     ##
##   # S #
# #   # S#
#   #  ###
##########
